11111111111
100000P0001
1000ECC0001
1000C000C01
10000W00001
11111111111